1111111111111111111111111
1C00000000000000000000C11
1010010100100000101001001
1010010010101010001001001
1P0000000C00N00000000E011
1010010010101010001001001
1010010100100000101001001
1C00000000000000000000C11
1111111111111111111111111